Greece
50 WxH 50
home_x_y 1000 800
3 5 5 5 5 5 5 5 5 5 5 5 5 5 5 5 1 1 1 1 1 1 1 1 1 1 1 1 1 1 1 5 5 5 3 3 3 3 3 5 5 5 5 3 3 1 1 3 5 5
 3 3 5 5 5 5 5 5 5 5 5 5 5 5 5 5 1 1 1 1 1 1 2 1 1 1 1 1 1 1 1 1 5 3 1 1 5 3 5 5 3 3 3 0 3 1 1 3 5 3
1 1 3 1 5 5 5 5 5 5 5 5 5 5 5 5 1 1 1 1 1 2 2 0 0 1 1 1 6 1 6 6 1 3 0 0 1 3 3 0 3 3 0 0 3 2 2 2 2 1
 2 1 3 5 5 5 5 5 5 5 5 5 5 5 5 5 1 1 1 1 2 0 0 0 0 5 5 1 1 1 1 1 3 0 0 0 0 0 0 0 0 0 0 0 0 0 0 0 2 1
0 1 1 5 5 5 5 5 5 5 5 5 5 5 3 5 5 1 1 1 2 0 0 0 2 1 1 5 5 5 1 5 5 5 0 0 0 0 0 0 1 3 0 0 0 0 0 0 0 2
 0 0 1 3 5 5 5 5 5 5 5 5 5 3 3 5 6 1 1 2 0 0 0 0 2 1 1 5 5 5 5 5 5 1 0 3 0 0 0 1 5 1 0 0 0 0 0 0 0 0
0 0 1 1 3 3 5 5 5 5 5 5 5 3 3 1 6 5 1 1 2 2 0 0 0 2 1 1 1 1 1 1 1 0 1 3 0 0 0 0 0 0 0 0 0 0 0 0 0 0
 0 0 5 1 1 1 5 5 5 5 5 5 3 1 1 1 5 5 1 1 2 0 0 0 0 2 2 1 0 0 1 1 0 0 0 3 0 0 0 0 0 0 0 0 0 0 0 0 0 0
0 0 0 1 1 1 1 5 5 5 5 5 5 3 1 1 1 5 5 5 1 0 0 0 0 0 0 2 0 0 0 1 0 0 0 0 5 0 0 0 0 0 0 0 0 0 0 0 0 0
 0 0 0 0 5 1 3 5 5 5 5 5 5 1 1 1 1 5 5 5 1 0 0 0 0 0 2 0 0 0 0 5 0 0 0 5 0 0 0 0 0 0 0 0 0 2 1 0 0 0
0 2 0 0 0 5 3 3 1 1 5 5 5 1 1 1 1 1 5 5 5 1 0 0 0 0 0 2 0 0 0 1 0 0 0 0 0 0 0 0 0 0 0 0 0 0 2 0 0 0
 0 2 0 0 0 3 3 1 5 5 5 5 5 1 6 1 1 1 5 5 1 1 3 0 0 0 0 2 0 0 1 0 0 0 0 0 0 0 0 0 0 0 0 0 0 0 0 0 0 0
0 0 0 0 0 1 1 1 1 1 1 5 5 5 1 1 1 1 1 1 1 6 3 0 0 0 0 0 0 0 0 0 0 0 0 0 0 0 0 0 0 0 0 0 0 0 0 0 0 0
 0 0 0 0 0 0 2 1 1 1 1 1 5 5 5 1 1 1 1 1 1 3 3 3 0 0 0 0 0 0 0 0 0 0 0 0 0 0 0 0 0 0 0 0 0 0 0 0 0 0
0 0 0 0 0 0 0 3 3 3 1 1 5 5 5 5 5 1 1 1 1 1 3 3 0 0 0 0 0 0 0 0 0 0 0 0 0 0 0 0 0 0 0 0 0 0 2 0 0 0
 0 0 0 0 0 0 3 3 3 3 3 3 5 5 6 1 1 1 1 1 1 1 1 1 1 1 3 0 0 0 0 0 0 0 0 0 2 0 0 0 0 0 0 2 2 1 0 0 0 0
0 0 0 0 0 0 0 0 0 0 0 3 3 5 5 6 1 1 1 1 1 1 1 1 1 1 0 3 3 0 0 0 0 0 0 0 0 0 0 0 0 0 0 0 2 1 2 0 0 0
 0 0 0 0 0 3 3 3 3 0 0 3 5 5 5 5 1 1 1 1 1 1 1 1 1 0 0 0 3 0 0 0 0 0 0 3 0 0 0 0 0 0 0 0 2 0 2 0 0 0
0 0 0 0 0 3 1 0 3 3 3 3 3 3 5 5 5 5 1 1 1 5 1 1 1 2 0 0 0 1 0 2 0 2 2 0 0 0 0 0 0 0 0 0 0 0 0 0 0 0
 0 0 0 0 3 3 0 0 0 3 3 3 3 3 3 5 5 5 5 5 5 5 1 1 1 2 2 0 3 0 0 0 0 1 0 0 0 0 0 0 0 0 0 0 0 0 0 0 0 0
0 0 0 0 0 0 0 1 0 2 1 1 1 1 6 6 5 5 5 5 5 5 5 1 1 1 1 2 0 0 0 0 0 0 0 0 0 0 0 0 0 0 0 2 0 0 0 0 0 0
 0 0 0 0 1 1 0 0 0 0 2 3 2 1 3 5 5 5 5 5 5 5 5 5 1 1 2 0 2 0 0 0 0 0 0 0 0 0 0 0 0 0 0 0 0 0 0 0 0 0
0 0 0 0 1 5 5 0 0 0 2 3 0 2 1 3 3 3 3 3 5 5 1 5 1 1 2 0 2 2 0 0 0 0 0 0 0 0 0 0 0 0 0 0 0 0 0 0 0 0
 0 0 0 1 0 5 1 0 0 2 1 0 0 0 1 0 0 3 0 3 5 1 1 1 1 2 0 2 1 1 0 0 0 0 0 0 0 0 0 0 0 0 0 0 0 0 0 0 0 0
0 0 0 0 0 0 0 0 0 0 0 0 0 0 0 0 1 0 0 0 3 5 1 1 1 1 2 0 0 1 1 0 0 0 0 0 0 0 2 2 0 0 0 0 0 0 0 0 0 0
 0 0 0 0 0 0 0 0 0 0 0 2 0 0 0 1 1 0 0 0 1 1 1 1 1 1 2 0 0 2 2 0 0 0 0 0 0 0 2 2 0 0 0 0 0 0 0 0 0 0
0 0 0 0 0 0 0 0 0 0 0 2 2 0 1 5 5 1 0 0 0 1 1 1 1 1 1 2 0 0 2 1 0 0 0 0 0 0 0 0 0 0 0 0 0 0 0 0 0 0
 0 0 0 0 0 0 0 0 0 0 0 2 2 2 1 5 5 5 0 0 0 1 5 5 1 1 1 2 0 0 1 1 0 0 0 0 0 0 0 0 0 0 0 0 0 0 0 0 0 0
0 0 0 0 0 0 0 0 0 0 0 2 1 1 1 5 5 5 1 0 0 0 1 5 5 1 1 1 2 0 1 1 1 0 0 0 0 0 0 0 0 0 0 0 0 0 0 0 0 0
 0 0 0 0 0 0 0 0 0 2 2 1 1 5 5 5 5 5 1 0 0 0 1 5 5 1 1 1 2 0 2 2 1 1 1 1 0 0 0 0 0 0 0 0 0 0 0 0 0 0
0 0 0 0 0 0 0 0 2 2 1 1 1 5 5 5 5 5 5 1 0 0 0 1 1 5 1 1 1 2 0 0 2 1 5 5 1 2 0 0 0 0 0 0 0 0 0 0 0 0
 0 0 0 0 0 0 0 2 2 1 1 1 6 3 3 5 5 5 5 1 0 0 0 0 1 1 1 1 1 2 2 0 0 1 1 1 2 2 0 0 0 0 0 0 0 0 0 0 0 0
0 0 0 5 0 0 0 0 0 2 1 1 1 3 3 3 3 5 5 5 1 0 0 0 0 1 2 1 6 1 6 2 0 0 0 0 0 2 2 0 0 0 0 0 0 0 0 0 0 0
 0 0 5 5 1 0 0 0 0 2 1 1 1 3 3 3 3 5 5 5 1 0 0 0 0 0 1 1 1 1 1 2 1 0 0 0 0 2 0 0 0 0 0 0 0 0 0 0 0 0
0 0 0 0 5 1 0 0 0 0 2 1 1 1 1 3 3 5 5 5 5 1 1 0 0 0 0 0 1 1 1 1 1 1 0 0 0 2 1 1 1 0 0 0 0 0 0 0 0 0
 0 0 0 0 0 0 0 0 0 0 2 1 1 1 1 5 3 5 5 5 1 1 1 0 0 1 0 0 1 1 1 1 1 1 0 0 0 0 1 5 1 0 0 0 0 0 0 0 0 0
0 0 0 0 0 0 0 0 0 0 0 1 1 1 1 5 5 1 5 5 5 1 1 1 0 0 1 1 1 2 2 2 2 1 2 2 2 0 0 1 0 1 0 0 0 0 0 0 0 0
 0 0 0 0 0 0 0 0 0 0 0 0 1 1 1 5 5 1 1 1 1 1 1 1 0 1 1 1 1 0 0 0 2 1 2 0 0 0 0 0 0 0 0 2 2 0 0 0 0 0
0 0 0 0 0 0 0 0 0 0 0 0 0 0 1 1 5 5 1 1 1 3 1 3 1 1 0 0 0 0 0 2 0 2 2 2 0 0 0 0 0 0 0 0 2 1 2 0 0 0
 0 0 0 0 0 0 0 0 0 0 0 0 0 1 1 1 5 1 1 1 3 3 3 5 5 1 1 0 0 0 0 0 0 0 2 0 0 2 2 0 0 0 0 0 0 2 2 0 0 0
0 0 0 0 0 0 0 0 0 0 0 0 1 1 1 1 5 5 5 1 1 3 3 3 5 1 1 1 0 0 0 2 0 0 0 0 0 0 2 0 0 0 0 0 0 0 0 0 0 0
 0 0 0 0 0 0 0 0 0 0 0 1 1 1 1 1 1 5 5 1 1 3 3 1 2 2 2 1 0 0 0 0 0 0 0 0 0 0 0 2 0 0 0 0 0 0 0 2 0 0
0 0 0 0 0 0 0 0 0 0 0 0 1 1 1 1 1 1 5 5 1 2 2 2 1 0 0 2 1 1 1 0 0 0 0 0 0 0 0 2 0 0 0 0 0 0 0 0 2 0
 0 0 0 0 0 0 0 0 0 0 0 2 1 1 1 2 0 0 0 1 2 0 0 1 1 0 0 2 2 1 1 0 0 0 0 0 0 0 0 0 2 0 0 0 0 0 0 0 0 0
0 0 0 0 0 0 0 0 0 0 0 0 2 1 1 1 0 0 1 1 2 0 0 0 2 1 0 0 0 2 2 0 2 0 0 0 0 0 0 0 0 0 2 0 0 0 0 0 0 0
 0 0 0 0 0 0 0 0 0 0 0 0 2 1 1 0 0 0 1 1 0 0 0 0 2 1 0 0 0 0 0 0 0 0 0 0 0 0 0 0 2 0 0 0 0 0 0 0 0 0
0 0 0 0 0 0 0 0 0 0 0 0 0 2 1 0 0 0 1 1 0 0 0 0 0 2 1 0 0 0 0 0 0 0 0 0 0 0 0 0 0 0 0 0 0 0 0 0 0 0
 0 0 0 0 0 0 0 0 0 0 0 0 0 0 0 0 0 0 1 1 0 0 0 0 0 2 1 0 0 0 0 0 0 0 0 0 0 0 2 2 0 0 0 0 0 0 0 0 0 0
0 0 0 0 0 0 0 0 0 0 0 0 0 0 0 0 0 0 0 0 1 0 0 0 0 0 0 1 0 0 0 0 0 0 0 0 0 0 0 0 0 0 0 0 0 0 0 0 0 0
 0 0 0 0 0 0 0 0 0 0 0 0 0 0 0 0 0 0 0 0 0 0 0 0 0 0 0 0 0 0 0 0 0 0 0 0 0 0 0 0 0 0 0 0 0 0 0 0 0 0